%%%%%%%%%%%%%%%%%%%%%%
%G%       ...      %P%
% %       ...      % %
% %       ...      % %
% % o     ...        %
% %                  %
% %           %%o% % %
% %%%%%%%%   %%%%%%% %
%         ...        %
%%%%%%%%%%%%%%%%%%%%%%
