%%%%%%%%%%%%%%%%%%%%%%%%%
%G%       ......      %P%
% %       ......      % %
% %       ......      % %
% % o     ......        %
% %%%%%%%%%%.%%%%%%%%%% %
% %              %%o% % %
% %%%%%%%%%%%%%%%%%%%%% %
%         ......        %
%%%%%%%%%%%%%%%%%%%%%%%%%
